{"author": "Yoshio Murase",
"title": "52 Maps Generated Automatically",
"levels": [
"########\n###  . #\n## * # #\n## .$  #\n##  #$##\n### @ ##\n########\n########",
"########\n##  .@ #\n## #.# #\n##   $ #\n##.$$ ##\n##  ####\n########\n########",
"########\n#### @##\n#  *$ ##\n#     ##\n## .####\n##$ ####\n## .####\n########",
"########\n##.###.#\n## #  .#\n## $$ @#\n##  $  #\n##  #  #\n##  ####\n########",
"########\n#### @##\n####   #\n#. #$$ #\n#     ##\n#.  $###\n##.  ###\n########",
"########\n# ..####\n# $    #\n#  #$# #\n# @ .$ #\n########\n########\n########",
"########\n###  .##\n# $ # ##\n# *$  ##\n# .#@ ##\n#    ###\n#   ####\n########",
"########\n########\n#.  @.##\n#  $# ##\n# # $. #\n#   $# #\n####   #\n########",
"########\n#. .####\n#.#$$ ##\n#   @ ##\n# $#  ##\n##   ###\n########\n########",
"########\n#.  ####\n# #   ##\n# . # ##\n# $*$ ##\n##@ ####\n##  ####\n########",
"########\n########\n#.   . #\n# # #  #\n#@$  $.#\n##### $#\n#####  #\n########",
"########\n#  #####\n#  #####\n# .*   #\n##$    #\n## #$###\n##. @###\n########",
"########\n## @ ###\n## .   #\n#. $.$ #\n##$# ###\n##   ###\n########\n########",
"########\n##   ###\n# $# ###\n# . @###\n# *   ##\n## #$ ##\n##.  ###\n########",
"########\n########\n##  ####\n#..$  .#\n# #$ $ #\n#@  #  #\n#####  #\n########",
"########\n##  .@##\n##   $.#\n####*# #\n##     #\n#  $  ##\n#   ####\n########",
"########\n##@ ####\n##  ####\n##. ####\n# $$. .#\n#  $ ###\n###  ###\n########",
"########\n########\n##.  ###\n## # ###\n## *$  #\n##  $. #\n##  @###\n########",
"########\n########\n###   ##\n### #.##\n###  .##\n#@ $$ ##\n#  .$ ##\n########",
"########\n#   @###\n# $# ###\n# * $  #\n#   ## #\n##.  . #\n###   ##\n########",
"########\n##   @##\n##  #  #\n##.  $ #\n## $$#.#\n####  .#\n########\n########",
"########\n########\n###. ###\n# .  ###\n#   $$ #\n## . $@#\n########\n########",
"########\n##@.  ##\n# $$* ##\n#  #  ##\n#  #  .#\n#### # #\n####   #\n########",
"########\n#####  #\n#####$.#\n###  . #\n###  #.#\n# $  $ #\n#   #@ #\n########",
"########\n#  .####\n# $.. ##\n#  ##$##\n##  #  #\n##$   @#\n##  ####\n########",
"########\n###  ###\n###  ###\n### .. #\n#  $#  #\n#  .$$ #\n#### @ #\n########",
"########\n#   ####\n# # *@##\n#  *   #\n###$   #\n###   .#\n########\n########",
"########\n### .  #\n# $@#. #\n#  $# ##\n#  *  ##\n##  # ##\n###   ##\n########",
"########\n########\n########\n##  ####\n#     ##\n#  #$$@#\n#  . *.#\n########",
"########\n##@    #\n#. #   #\n# $$$.##\n# .#  ##\n#  #####\n########\n########",
"########\n#      #\n# # ##*#\n# #@ $ #\n#.$ .  #\n#####  #\n#####  #\n########",
"########\n##@   ##\n###$   #\n### .  #\n# $ #$##\n# .  .##\n####  ##\n########",
"########\n#   ####\n#  $  ##\n##$$ .##\n##@ . ##\n### # ##\n###  .##\n########",
"########\n#   ####\n# $$   #\n# .#.  #\n#  ## ##\n#  ##$##\n# @  .##\n########",
"########\n########\n########\n# .  ###\n# .# ###\n# @$$  #\n# $.   #\n########",
"########\n# @.#  #\n# .$ . #\n#  #$  #\n#  $  ##\n###  ###\n###  ###\n########",
"########\n#    . #\n# $  $@#\n#.$.####\n#  #####\n#  #####\n#  #####\n########",
"########\n# .  ###\n#  #@###\n#  $ ###\n##$#  ##\n#   # ##\n#. *  ##\n########",
"########\n########\n#### . #\n# *@ . #\n# $ #  #\n# #  $ #\n#   ####\n########",
"########\n########\n########\n###  ###\n# .. $.#\n#  $$ @#\n####   #\n########",
"########\n########\n#####@ #\n##### .#\n# $ $ $#\n#   .  #\n### .  #\n########",
"########\n#   #  #\n# #.$ $#\n#   $  #\n#####. #\n###   @#\n###   .#\n########",
"########\n####@ ##\n###  ..#\n## $#$##\n#   $. #\n#  #   #\n#    ###\n########",
"########\n#   @###\n# $$####\n# $ .  #\n## #.# #\n#.   # #\n#      #\n########",
"########\n####  ##\n#### $##\n# @$.  #\n# ##   #\n#   ## #\n#   * .#\n########",
"########\n#### @ #\n####   #\n## $ $##\n## $  ##\n#.  # ##\n#..   ##\n########",
"########\n########\n####. @#\n#  .$  #\n# #  ###\n# $ $ .#\n####   #\n########",
"########\n########\n#  .# @#\n# # $  #\n# $.#$ #\n## .   #\n##  ####\n########",
"########\n########\n##     #\n##.## .#\n##*  $@#\n##  #$ #\n##  #  #\n########",
"########\n#. #####\n# $#####\n#  #####\n# .$ @ #\n# .$ # #\n###    #\n########",
"########\n#      #\n# #$   #\n# $ @#.#\n##$#.  #\n##    .#\n########\n########",
"########\n#  . ###\n#    ###\n# #$$. #\n#.  ## #\n#@$ ## #\n###    #\n########"
]}
